NO texture/turtle_north.xpm
SO texture/penguin_south.xpm
WE texture/orca_west.xpm
EA texture/seahorse_east.xpm

F 128,128,128
C 0,255,255

11111111111111111111111111111111111111
10000010000000000100000000000000000001
10111010011111110101111111011111111111
100N1010010000000101101010000000000001
11111010011011111100100010111111111111
10000010001010000110101010110000000001
10111111101010110010101000000111111101
10100000101010011010101111110100000001
10101110101010001000100000010100000001
10101000101011101111111111010100000001
100010000010000000000000000101000000001
1111111111111111111111111111111111111