NO texture/turtle_north.xpm
SO texture/penguin_south.xpm
WE texture/orca_west.xpm
EA texture/seahorse_east.xpm

F 220,100,0
C 60,30,40

11111111111
1N000001001
10000001N01
10000000001
1000N000001
11111111111