NO ./images/no5.xpm
SO ./images/no6.xpm
WE ./images/no7.xpm
EA ./images/no8.xpm

F 255,255,255
C 206,17,38

111111111111111111111111111111111111111111111111111111111111
100000000000000000000000000001
100000000000000000000000000001
10000000000000N000000000000001
100000000000000000000000000001
100000000000000000000000000001
111111111111111111111111111111
